wwwwwwwwwwwwwwwwwwwwwwwwwwwwwwwwwww
wwwwwwwwwwwwwwwwwwwwwwwwwwwwwwwwwww
w...........m.....................w
w.swwwwsw..wwwwwswwwwws.w....w....w
w.s..w.s...w....sw...ws.ww...w....w
w.s..w.s...www..swwwwws.w.w..w....w
w.s.iw.s...w....sw...ws.w..w.w....w
w.wwww.s...wwww.sw...ws.w...ww....w
w......s.m......s.....s...........w
w.wwwwwwwwwwwwwwww....s...........w
w.....................s..m........w
w.....w......wwwwwwwwwwwwwwwwwwwwsw
w................................sw
w....wswwwwwswwwwwwws............sw
w....wsw....s......ws....m.......sw
w....wsw....s......wwwwwwwwwwwwwwww
w....wsw....s.....................w
w....wsw....s.....................w
w....wsw....s.....................w
w...w.s.w...wwwwwwsw..............w
w..w..s..w........s...............w
w.w...s..kw.......s....m..........w
w.wwwwwwwww..wwwwwwwwwswwwwww.....w
wo....................s...........w
wwwwwwwwwwwwwwwwwwwwwwwwwwwwwwwwwww
