wwwwwwwwwwwwwwwwwwwwwwwwwwwwwwwwwww
w.........wwwwwwwww...............w
w.........w.......................w
w.........w......swwwwwwwswwwwwwwww
w.........wi.....sw......s........w
w.........wwwwwwwww......s........w
w........................s........w
w........................s........w
w........................s........w
w........................s........w
w........................s........w
w........................s........w
w.........m..............s........w
w.wwwwswwwwwws...........s........w
w.....s.....ws...........s........w
w.....s.....ws...........s........w
w.wwwwwws...ws...........s........w
w.......s...ws...........s.....w..w
w.......s...ws...........s.....w..w
w.......s...ws........m..s.....w..w
w.......s...wwwwwwwwwwwwwwwwwwww..w
w....swwwwwww.....................w
w....s..............k.............w
w....s.......m...wwwwww....o......w
wwwwwwwwwwwwwwwwwwwwwwwwwwwwwwwwwww
