wwwwwwwwwwwwwwwwwwwwwwwwwwwwwwwwwww
w...............w.................w
w.sws...........wswwwwwwwwswwww...w
w.sws...........ws.w......s.......w
w.sws...........ws.w......s.......w
w.sws.sws.......ws.w...m..s.......w
w.sws.sws.......ws.wwwwwwwwwsw....w
w.sws.sws.......ws.....w....s.....w
w.sws.swwwwwws..ws.....w....s.....w
w.sws.sw.....s..ws.....w....s.....w
w.sws.swswwwwwwwwwws...w....s.....w
w.sws.sws....w.....s...w....s.....w
w.sws.sws....w.....s...w....s.....w
w.sws.sws....w.....s...w....s.....w
w.sws.sws....w.....s...w....s.....w
w.sws.sws....w..m..s...w....s.....w
w.sws.swwwswwwwwwswwwwww....s.....w
w.sws.sw..s......s.w........s.....w
w.sws.sw..s......s.w........s.....w
w.sws.sw..s......s.w........s.....w
w.sws.sw..s......s.w........s.....w
w.sws.sw..s......s.w........s.....w
w.sws.sw..s......s.w........s.....w
wisws.sw..s..m...s.w........s....ow
wwwwwwwwwwwwwwwwwwwwwwwwwwwwwwwwwww
