wwwwwwwwwwwwwwwwwwwwwwwwwwwwwwwwwww
w.......wi............w...........w
w.......wwwwwwwwwwwwwsw...........w
w....w...............s......w.....w
w....w...............s......w.....w
w....w......m........s......w ....w
w....wwswwwwwwwwwwwwwwwwwwwww.....w
w....w.s..........................w
w....w.s..........................w
w....w.s..........................w
w....wwwwwww..................wwwww
w...........wwwww........m....w...w
w................wwwwwswwwwwwww...w
w..w..................s...w.......w
w..w......m...........s...w.......w
w..wwwwwwwwwwwswwwwwwwwwwww.......w
w.............s.......w...........w
w.............s.......w...........w
w.............s.......w...........w
wwwwswww......s.......w..........ow
w...s.........s.......w.....wswwwww
w...s.........s..............s....w
w...s.........s......www.....s....w
w...s.....m...s.....wwwww.m..s....w
wwwwwwwwwwwwwwwwwwwwwwwwwwwwwwwwwww
